12
12
WWWWWWWWWWWW
W W W W X  W
W   W W X  W
W W W   X  W
W W W W X  W
W W     X  W
W W  E  X  W
W W     X  W
W WWW W X  W 
W  WW W X WW
W         SW
WWWWWWWWWWWW