12
12
WWWWWWWWWWWW
W W W W W  W
W   W W W  W
W W W   W  W
W W W W W  W
W W     W  W
W W  E  W  W
W W     W  W
W WWW W W  W 
W  WW W W WW
W          W
WWWWWWWWWWWW