12
12
WWWWWWWWWWWW
WS W W W W W
W    W W   W
W  W W W W W
W  W W W W W
W  W W W W W
W  W   W W W
W  W W W W W
W  W W W W W
W  W W W W W
WE W W   W W
W  W WWW WEW
WWWWWWWWWWWW