11
11
WWWWWWWWWWW
W W W W W W
W W W W W W
W W W W W W
W W W W W W
W W  SW W W
W W W W W W
W W W W W W
W W W W W W
W W EEW W W
WWWWWWWWWWW