12
12
WWWWWWWWWWWW
W W W W W  W
W   W W W  W
W W W   W  W
W W W W W  W
W W W W W  W
W W  EW W  W
W W W W W  W
W WWW W W  W
W  WW W W WW
W         SW
WWWWWWWWWWWW