12
12
WWWWWWWWWWWW
W   W W W  W
WE  W W W  W
W       W  W
W  WW W W WW
W  WW W W  W
W  WWSW W  W
W  WW W W  W
W  WW W W  W
W  WW W W WW
W     W    W
WWWWWWWWWWWW