10
11
WWWWWWWWWWW
WE    W W W
W       W W
W     W W W
W W  S    W
W W W W W W
W W W W W W
W WWWWWWW W
W W     W W
WWWWWWWWWWW