11
10
WWWWWWWWWW
W    W W W
WWW  WWW W
WWW  W W W
WWWS   W W
W    WWW W
WW       W
WW W W W W
WW W WWW W
W  WWWE  W
WWWWWWWWWW